18
25
30
111111111111111111
100001000000500001
101101010110111111
101000010010010001
101111111011010101
100001000000010101
101101011111010101
101000001000010101
101110101011010001
100000100000050101
111111101011111101
161000001010000001
101010101011511101
101010100000010101
101010101110110101
101000101000010101
100010000011000102
111111111111111111
1111111111111111111111111
1000000100001000100010001
1010110111101010101010101
1010100000101010101010101
1010111110100010001000101
1010000010101111111110101
1010111010000000016000101
1010100011111011011110101
1000101000001010001000001
1011111010101010101111101
1010001010101010100000001
1010100010100010101110101
1010111110101110100010101
1010000000100000101010101
1011010111111010101010101
1000010100000010101010101
1011110101111110101010101
1000000000000000000010001
1011111111111111011011111
1010000000000000000010001
1010111011111111101110101
1010101000000000100050001
1010151111111110111110101
1000000000000000000050002
1111111111111111111111111
111111111111111111111111111111
100000000000010000000100000001
101111111101010111111101010101
100000001001010010000001010101
101110100001000010011101010101
100010111111111010010001010101
101010000000001010010111010101
101011111111101011110100010101
101000100000101000000101110101
101110101010101011111101000101
101010101010101000000001011101
101010101010101111111101000101
101000001010000000000001110101
101010101011111111011100010101
101010101010000001010111010101
101010101011111101010000010101
101010101000000001010111110101
101010101111111101010100000101
101010100000000001010101111101
101010101111111111010101000001
100000001000000000010101011111
111111101011111111510000000001
100000000010001000011011111111
111111101010101010001000000061
100000501010101010101111111111
101111101010101010100000000001
101000101010101010111111111151
101110101010101010100010001001
100000101000100010001000105002
111111111111111111111111111111